say	said
walk	walked
see	saw
sleep	slept
strike	struck
shrink	shrank
feed	fed
describe	described
dance	danced
spend	spent
sing	sang
fly	flew
write	wrote
look	looked
go	went
fall	fell
read	read
know	knew
generate	generated
sell	sold
enhance	enhanced
sit	sat
predict	predicted
implement	implemented
run	ran
jump	jumped
move	moved
listen	listened
scream	screamed
hide	hid
pay	paid
increase	increased
take	took
vanish	vanished
think	thought
decrease	decreased
play	played
swim	swam
can     could
