govoriti	govorio
hodati	hodao
gledati	gledao
usporavati	usporio
spavati	spavao
udarati	udario
skupljati	skupio
pogađati	pogodio
hraniti	hranio
opisivati	opisao
plesati	plesao
trošiti	trošio
pjevati	pjevao
letjeti	letio
pisati	pisao
tražiti	tražio
odlaziti	odlazio
padati	pao
čitati	čitao
poznati	poznao
generirati	generirao
prodavati	prodao
poboljšati	poboljšao
sjediti	sjedio
predviđati	predviđao
uvoditi	uvodio
trčati	trčao
skakati	skakao
micati	micao
slušati	slušao
vrištati	vrištao
skrivati	skrivao
plaćati	platio
povećati	povećao
uzimati	uzimao
nestati	nestao
razmišljati	razmišljao
smanjiti	smanjio
igrati	igrao
plivati	plivao