cierto	incierto
aceptable	inaceptable
afortunado	desafortunado
posible	imposible
agradable	desagradable
sabido	desconocido
razonable	irrazonable
posiblemente	imposiblemente
consistente	inconsistent
productivo	improductivo
responsable	irresponsable
racional	irracional
l贸gico	il贸gico
honesto	deshonesto
probable	improbable
conveniente	inconveniente
eficiente	ineficiente
c贸modo	inc贸modo
consciente	inconsciente
decidido	indeciso