etičan	neetičan
siguran	nesiguran
dosljedan	nedosljedan
konkurentan	nekonkurentan
udoban	neudoban
vjerojatan	nevjerojatan
odlučan	neodlučan
produktivan	neproduktivan
učinkovit	neučinkovit
zgodan	nezgodan
odgovoran	neodgovoran
informiran	neinformiran
sretan	nesretan
racionalan	iracionalan
siguran	nesiguran
ukusan	neukusan
prihvatljiv	neprihvatljiv
uvjerljiv	neuvjerljiv
moguće	nemoguće
svjestan	nesvjestan
ugodan	neugodan
moguće	nemoguće
logičan	nelogičan
poznat	nepoznat
impresivno	neipresivno
jasan	nejasan
pošten	nepošten
informativan	neinformativan
razuman	nerazuman