heavy	heavier
old	older
simple	simpler
sweet	sweeter
hard	harder
cheap	cheaper
deep	deeper
high	higher
bright	brighter
tasty	tastier
long	longer
sharp	sharper
cold	colder
slow	slower
tough	tougher
young	younger
fast	faster
tight	tighter
hot	hotter
strange	stranger
low	lower
easy	easier
new	newer