dobar	bolji
zao	gori
taman	tamniji
visok	viši
debeo	deblji
mršav	mršaviji
jeftin	jeftiniji
malen	manji
čist	čišći
star	stariji
mlad	mlađi
lak	lakši
mek	mekši
lijep	lješi
jak	jači
velik	veći
ljen	ljeniji
slan	slanji
dug	duži
krut	krući
suh	suši
topao	topliji
labav	labaviji
poseban	posebniji
ljut	ljući
jasan	jasniji
zelen	zeleniji
crven	crveniji
hrapav	hrapaviji
slab	slabiji
marljiv	marljiviji
plemenit	plemenitiji
razigran	razigraniji
zločest	zločestiji
brz	brži
blag	blaži
blijed	bljeđi
žut	žući
čvrst	čvršći
lud	luđi
glup	gluplji
vrijedan	vrjedniji
bijel	bjelji
nijem	njemiji
siv	siviji
crn	crnji
lak	lakši
krnj	krnji
vruć	vrući
tih	tiši
mrk	mrkiji
krepak	krepkiji
krotak	krotkiji
mrzak	mrži
bijesan	njesniji
bistar	bistriji
gladan	gladniji
jednostavan	jednostavniji
složen	složeniji
kos	kosiji
ravan	ravniji
stran	straniji
štur	šturiji
slan	slaniji
sladak	slađi
gorak	gorči
težak	teži
širok	širi
dalek	dalji
dubok	dublji
blizak	bliži
tanak	tanji
plitak	plići
uzak	uži
gust	gušći
strm	strmiji
zdrav	zdraviji