magarac	magarci
boja	boje
dolar	dolari
svinja	svinje
lav	lavovi
kompjuter	kompjuteri
noun	plural
miš	miševi
oblak	oblaci
konj	konji
oko	oči
majmun	majmuni
stroj	strojevi
prst	prsti
slon	slonovi
lubenica	lubenice
koza	koze
ptica	ptice
štakor	štakori
orao	orlovi
žena	žene
banana	banane
kruška	kruške
ruka	ruke
zmija	zmije
dijete	djeca
muškarac	muškarci
zgrada	zgrade
luk	luk
krava	krave
auto	auti
pas	psi
mačka	mačke
televizor	televizori
boca	boce
jabuka	jabuke
san	snovi
cesta	ceste
kolač	kolači
momčad	momčadi
bol	boli
knjiga	knjige
plovidba	plovidbe
pobjeda	pobjede
vrata	vrata
fakultet	fakulteti