chlapec	dívka	
bratr	sestra
bratranec	bratranice
táta	máma
děda	babička
vnuk	vnučka
pravnuk	pravnučka
ženich	nevěsta
on	ona
otčím	macecha
jeho	ji
manžel	manželka
král	královna
muž	žena
synovec	neteř
princ	princezna
syn	dcera
strýc	teta
švagr	švagrová
tchán	tchýně
kmotr	kmotra
ženich	nevěsta
pastorek	pastorkyně
pratchán	pratchýně
sirotek	sirota
vdovec	vdova