Sohn	Tochter
Neffe	Nichte
Stiefel	Stieftochter
Vater	Mutter
Prinz	Prinzessin
er	sie
Vater	Mutter
sein	ihr
Bruder	Schwester
König	Königin
Söhne	Töchter
Opa	Oma
Mann	Frau
Junge	Mädchen
Enkel	Enkelin
Bräutigam	Braut
Bruder	Schwester
Großvater	Großmutter
Stiefbruder	Stiefschwester
Onkel	Tante
Stiefvater	Stiefmutter
Ehemann	Ehefrau
Pate	Patin
Witwe	Witwer