son	daughter
nephew	niece
stepson	stepdaughter
father	mother
prince	princess
he	she
dad	mom
his	her
brother	sister
king	queen
son	daughter
grandpa	grandma
man	woman
boy	girl
grandson	granddaughter
groom	bride
brother	sister
grandfather	grandmother
stepbrother	stepsister
uncle	aunt
stepfather	stepmother
husband	wife
godfather	godmother
widow	widower