padre	madre
él	ella
sobrino	sobrina
nieto	nieta
chico	chica
novio	novia
hijos	hijas
hijo	hija
papá	mamá
hombre	mujer
hermanastro	hermanastra
tío	tía
hermano	hermana
hermanos	hermanas
rey	reina
hijastro	hijastra
abuelo	abuela
esposo	esposa
príncipe	princesa
padrastro	madrastra