brat	sestra
bratić	sestrična
car	carica
dječak	djevojčica
djed	baka
djever	djeveruša
knez	kneginja
kralj	kraljica
kum	kuma
ljubavnik	ljubavnica
mladoženja	mladenka
momak	djevojka
muž	žena
nećak	nećakinja
očuh	maćeha
on	ona
otac	majka
pastorak	pastorka
podanik	podanica
polubrat	polusestra
poočim	pomajka
posinak	pokćerka
prabaka	pradjed
praunuk	praunuka
princ	princeza
punac	punica
rođak	rođakinja
sin	kći
sluga	sluškinja
stric	strina
suprug	supruga
susjed	susjeda
svekar	svekrva
šogor	šogorica
šukunbaba	šukundjed
šurjak	šurjakinja
tata	mama
tetak	teta
udovac	udovica
ujak	ujna
zet	nevjesta