figlio	figlia
patrigno	matrigna
fratellastro	sorellastra
marito	moglie
padre	madre
figli	figlie
sposo	sposa
suo	sua
ragazzo	ragazza
poliziotto	poliziotta
principe	principessa
re	regina
nonnno	nonna
lui	lei
fratelli	sorelle
figliastro	figliastra
fratello	sorella
uomo	donna
zio	zia
babbo	mamma