smart	smartest
good	best
big	biggest
safe	safest
weak	weakest
lucky	luckiest
dark	darkest
small	smallest
warm	warmest
strong	strongest
cool	coolest
wide	widest
great	greatest
short	shortest
large	largest
bad	worst
quick	quickest
tall	tallest
weird	weirdest
loud	loudest