dobar	najbolji
zao	najgori
taman	najtamniji
visok	najviši
debeo	najdeblji
mršav	najmršaviji
jeftin	najjeftiniji
malen	najmanji
čist	najčišći
star	najstariji
mlad	najmlađi
lak	najlakši
mek	najmekši
lijep	najljepši
jak	najjači
velik	najveći
ljen	najljeniji
slan	najslanji
dug	najduži
krut	najkrući
suh	najsuši
topao	najtopliji
labav	najlabaviji
poseban	najposebniji
ljut	najljući
jasan	najjasniji
zelen	najzeleniji
crven	najcrveniji
hrapav	najhrapaviji
slab	najslabiji
marljiv	najmarljiviji
plemenit	najplemenitiji
razigran	najrazigraniji
zločest	najzločestiji
brz	najbrži
blag	najblaži
blijed	najbljeđi
žut	najžući
čvrst	najčvršći
lud	najluđi
glup	najgluplji
vrijedan	najvrjedniji
bijel	najbjelji
nijem	najnjemiji
siv	najsiviji
crn	najcrnji
lak	najlakši
krnj	najkrnji
vruć	najvrući
tih	najtiši
mrk	najmrkiji
krepak	najkrepkiji
krotak	najkrotkiji
mrzak	najmržiji
bijesan	najbjesniji
bistar	najbistriji
gladan	najgladniji
jednostavan	najjednostavniji
složen	najsloženiji
kos	najkosiji
ravan	najravniji
stran	najstraniji
štur	najšturiji
slan	najslaniji
sladak	najslađi
gorak	najgorči
težak	najteži
širok	najširi
dalek	najdalji
dubok	najdublji
blizak	najbliži
tanak	najtanji
plitak	najplići
uzak	najuži
gust	najgušći
strm	najstrmiji
zdrav	najzdraviji