Paříž	Francie
Oslo	Norsko
Hanoi	Vietnam
Atény	Řecko
Kábul	Afghánistán
Moskva	Rusko
Tokio	Japonsko
Bagdád	Irák
Bangkok	Thajsko
Berlín	Německo
Teherán	Írán
Bern	Švýcarsko
Havana	Kuba
Helsinki	Finsko
Islamabad	Pákistán
Ottawa	Kanada
Řím	Itálie
Stockholm	Švédsko
Peking	Čína
Canberra	Austrálie
Káhira	Egypt
Londýn	Anglie
Madrid	Španělsko