Paris	Frankreich
Oslo	Norwegen
Hanoi	Vietnam
Athen	Griechenland
Kabul	Afghanistan
Moskau	Russland
Tokyo	Japan
Baghdad	Iraq
Bangkok	Thailand
Berlin	Deutschland
Teheran	Iran
Bern	Schweiz
Havanna	Kuba
Helsinki,	Finnland
Islamabad	Pakistan
Ottawa	Kanada
Rom	Italien
Stockholm	Schweden
Peking	China
Canberra	Australien
Kairo	Ã„gypten
London	England
Madrid	Spanien