Paris	France
Oslo	Norway
Hanoi	Vietnam
Athens	Greece
Kabul	Afghanistan
Moscow	Russia
Tokyo	Japan
Baghdad	Iraq
Bangkok	Thailand
Berlin	Germany
Tehran	Iran
Bern	Switzerland
Havana	Cuba
Helsinki	Finland
Islamabad	Pakistan
Ottawa	Canada
Rome	Italy
Stockholm	Sweden
Beijing	China
Canberra	Australia
Cairo	Egypt
London	England
Madrid	Spain