Canberra	Australia
Ottawa	Canadá
Estocolmo	Suecia
Berlín	Alemania
París	Francia
Beijing	China
Tokio	Japón
Londres	Inglaterra
Atenas	Grecia
Berna	Suiza
Islamabad	Pakistán
Helsinki	Finlandia
Roma	Italia
Bangkok	Tailandia
Hanoi	Vietnam
Madrid	España
Oslo	Noruega
Bagdad	Irak
Kabul	Afganistán
Moscú	Rusia
Teherán	Iran