Pariz	Francuska
Oslo	Norveška
Hanoj	Vijetnam
Atina	Grčka
Kabul	Avganistan
Moskva	Rusija
Tokijo	Japan
Bagdad	Irak
Bankok	Tajland
Berlin	Njemačka
Teheran	Iran
Bern	Švicarska
Havana	Kuba
Helsinki	Finska
Islamabad	Pakistan
Otava	Kanada
Rim	Italija
Stockholm	Švedska
Peking	Kina
Kanbera	Australija
Kairo	Egipat
London	Engleska
Madrid	Španija