Mosca	Russia
Pechino	Cina
Oslo	Norvegia
Hanoi	Vietnam
Kabul	Afghanistan
Berna	Svizzera
Tokyo	Giappone
Bangkok	Thailandia
Baghdad	Iraq
Tehran	Iran
Havana	Cuba
Helsinki	Finlandia
Islamabad	Pakistan
Ottawa	Canada
Roma	Italia
Londra	Inghilterra
Stoccolma	Svezia
Parigi	Francia
Canberra	Australia
Cairo	Egitto
Atene	Grecia
Berlino	Germania
Madrid	Spagna