Brazílie	real
Kanada	dolar
Amerika	dolar
Kambodža	riel
Argentina	peso
Nigérie	naira
Evropa	euro
Korea	won
Írán	riál
Alžírsko	dinár
Arménie	dram
Thajsko	baht
Ukrajina	hřivna
Dánsko	koruna
Polsko	zlotý
Makedonie	denar
Švédsko	krona
Lotyšsko	lat
Chorvatsko	kuna
Maďarsko	forint
Rusko	rubl
Bulharsko	lev
Rumunsko	leu
Angola	kwanza
Mexiko	peso
Indie	rupie
Malajsie	ringgit
Vietnam	dong
Japonsko	jen