Brasilien	Real
Kanada	Dollar
USA	Dollar
Kambodscha	Riel
Argentinien	Peso
Nigeria	Naira
Europa	Euro
Korea	Won
Iran	Rial
Algerien	Dinar
Armenien	Dram
Thailand	Baht
Ukraine	Hrywna
Dänemark	Krone
Polen	Zloty
Mazedonien	Denar
Schweden	Krone
Lettland	Lats
Kroatien	Kuna
Ungarn	Forint
Russland	Rubel
Bulgarien	Lew
Rumänien	Leu
Angola	Kwanza
Mexiko	Peso
Indien	Rupie
Malaysia	Ringgit
Vietnam	Dong
Japan	Yen