Brazil	real
Canada	dollar
USA	dollar
Cambodia	riel
Argentina	peso
Nigeria	naira
Europe	euro
Korea	won
Iran	rial
Algeria	dinar
Armenia	dram
Thailand	baht
Ukraine	hryvnia
Denmark	krone
Poland	zloty
Macedonia	denar
Sweden	krona
Latvia	lats
Croatia	kuna
Hungary	forint
Russia	ruble
Bulgaria	lev
Romania	leu
Angola	kwanza
Mexico	peso
India	rupee
Malaysia	ringgit
Vietnam	dong
Japan	yen