Argentina	peso
Europa	euro
Canadá	dólar
Angola	kwanza
Bulgaria	lev
Corea	ganó
México	peso
Vietnam	dong
Armenia	dracma
Letonia	lats
Macedonia	denar
Iran	rial
Hungría	forint
Japón	yen
Rumania	leu
Rusia	rublo
India	rupia
Nigeria	naira
Tailandia	baht
Argelia	dinar
Ucrania	hryvnia
Polonia	zloty
Brasil	real
Camboya	riel
Lituania	litas
Croacia	kuna
EEUU	dólar
Malasia	ringgit