Australija	dolar
Kanada	dolar
Češka	kruna
Danska	kruna
Mađarska	forinta
Japan	jen
Norveška	kruna
Švedska	kruna
Švicarska	franak
Velika_Britanija	funta
SAD	dolar
Poljska	zloti
Rumunjska	leu
Bugarska	lev
Albanija	lek
Srbija	dinar
Hrvatska	kuna
Turska	lira
Makedonija	denar
Estonija	kruna
Rusija	rubalj