Canada	dollaro
USA	dollaro
Svezia	corona
Malesia	ringgit
Argentina	peso
Nigeria	naira
Iran	rial
Cambogia	riel
Algeria	dinaro
Danimarca	corona
Armenia	dram
Ucraina	grivnia
Croazia	kuna
Messico	peso
Thailandia	baht
Corea	won
Macedonia	dinaro
Polonia	zloty
Europa	euro
Russia	rublo
Bulgaria	lev
Romania	leu
Angola	kwanza
Brasile	real
India	rupia
Ungheria	fiorino
Vietnam	dong
Lettonia	lats
Giappone	yen